GROUP,PACKAGE,CLASS,INSTRUCTION_MISSED,INSTRUCTION_COVERED,BRANCH_MISSED,BRANCH_COVERED,LINE_MISSED,LINE_COVERED,COMPLEXITY_MISSED,COMPLEXITY_COVERED,METHOD_MISSED,METHOD_COVERED,TOTAL_STATEMENTS,STATEMENT_COVERAGE,TOTAL_BRANCH,BRANCH_COVERAGE,COMPLEXITY
JFreeChart,org.jfree.chart.plot,PlotRenderingInfo,45,148,9,11,13,42,8,16,1,13,193,0.766839378,20,0.55,24
JFreeChart,org.jfree.chart.plot,CombinedDomainXYPlot,351,557,59,53,89,153,53,33,13,17,908,0.613436123,112,0.473214286,86
JFreeChart,org.jfree.chart.plot,PolarPlot,1198,1103,178,104,340,312,158,77,53,41,2301,0.479356801,282,0.368794326,235
JFreeChart,org.jfree.chart.plot,DatasetRenderingOrder,12,49,4,6,5,17,5,6,1,5,61,0.803278689,10,0.6,11
JFreeChart,org.jfree.chart.plot,DialShape,24,48,8,4,9,14,7,5,1,5,72,0.666666667,12,0.333333333,12
JFreeChart,org.jfree.chart.plot,Plot,386,785,88,92,138,262,87,72,21,48,1171,0.670367208,180,0.511111111,159
JFreeChart,org.jfree.chart.plot,PiePlotState,0,80,0,0,0,34,0,21,0,21,80,1,0,0,21
JFreeChart,org.jfree.chart.plot,ThermometerPlot,1185,761,118,74,269,201,125,45,48,25,1946,0.391058582,192,0.385416667,170
JFreeChart,org.jfree.chart.plot,RingPlot,422,262,45,25,123,91,37,28,14,16,684,0.383040936,70,0.357142857,65
JFreeChart,org.jfree.chart.plot,PiePlot,983,2765,126,218,254,803,130,174,33,99,3748,0.737726788,344,0.63372093,304
JFreeChart,org.jfree.chart.plot,PieLabelDistributor,107,227,13,21,22,50,10,16,2,7,334,0.679640719,34,0.617647059,26
JFreeChart,org.jfree.chart.plot,PieLabelRecord,38,157,7,19,10,46,10,19,4,12,195,0.805128205,26,0.730769231,29
JFreeChart,org.jfree.chart.plot,PlotState,0,11,0,0,0,4,0,2,0,2,11,1,0,0,2
JFreeChart,org.jfree.chart.plot,FastScatterPlot,213,804,37,65,70,233,49,52,20,30,1017,0.790560472,102,0.637254902,101
JFreeChart,org.jfree.chart.plot,CompassPlot,821,374,69,36,167,111,66,26,17,18,1195,0.312970711,105,0.342857143,92
JFreeChart,org.jfree.chart.plot,DefaultDrawingSupplier,12,765,6,50,4,166,5,41,0,18,777,0.984555985,56,0.892857143,46
JFreeChart,org.jfree.chart.plot,CategoryMarker,6,93,3,7,3,27,3,10,0,8,99,0.939393939,10,0.7,13
JFreeChart,org.jfree.chart.plot,Crosshair,56,582,1,33,20,161,18,39,17,23,638,0.912225705,34,0.970588235,57
JFreeChart,org.jfree.chart.plot,MeterPlot,178,1347,49,93,51,371,62,65,18,38,1525,0.883278689,142,0.654929577,127
JFreeChart,org.jfree.chart.plot,IntervalMarker,20,116,2,10,5,34,4,13,2,9,136,0.852941176,12,0.833333333,17
JFreeChart,org.jfree.chart.plot,AbstractPieLabelDistributor,0,31,0,0,0,10,0,5,0,5,31,1,0,0,5
JFreeChart,org.jfree.chart.plot,CombinedRangeXYPlot,352,508,59,43,96,144,50,29,12,16,860,0.590697674,102,0.421568627,79
JFreeChart,org.jfree.chart.plot,CombinedRangeCategoryPlot,200,513,41,45,53,146,38,25,6,14,713,0.719495091,86,0.523255814,63
JFreeChart,org.jfree.chart.plot,MultiplePiePlot,365,416,50,34,95,126,37,30,6,19,781,0.532650448,84,0.404761905,67
JFreeChart,org.jfree.chart.plot,MeterInterval,12,123,6,8,6,36,6,11,0,10,135,0.911111111,14,0.571428571,17
JFreeChart,org.jfree.chart.plot,XYCrosshairState,3,0,0,0,2,0,1,0,1,0,3,0,0,0,1
JFreeChart,org.jfree.chart.plot,PlotOrientation,6,66,2,8,2,24,3,10,1,7,72,0.916666667,10,0.8,13
JFreeChart,org.jfree.chart.plot,WaferMapPlot,581,0,44,0,152,0,36,0,14,0,581,0,44,0,36
JFreeChart,org.jfree.chart.plot,PolarAxisLocation,6,117,3,19,3,42,3,13,0,5,123,0.951219512,22,0.863636364,16
JFreeChart,org.jfree.chart.plot,CombinedDomainCategoryPlot,301,550,49,47,81,149,46,27,10,15,851,0.646298472,96,0.489583333,73
JFreeChart,org.jfree.chart.plot,XYPlot,1777,4759,328,538,489,1328,289,375,50,181,6536,0.728121175,866,0.621247113,664
JFreeChart,org.jfree.chart.plot,ValueMarker,11,57,1,7,3,19,2,8,1,5,68,0.838235294,8,0.875,10
JFreeChart,org.jfree.chart.plot,SpiderWebPlot,236,1447,43,101,72,412,55,86,19,50,1683,0.859774213,144,0.701388889,141
JFreeChart,org.jfree.chart.plot,CategoryPlot,1208,4161,229,463,336,1191,215,352,44,177,5369,0.775004656,692,0.669075145,567
JFreeChart,org.jfree.chart.plot,Marker,24,495,7,35,10,137,9,49,2,35,519,0.953757225,42,0.833333333,58
JFreeChart,org.jfree.chart.plot,PiePlot3D,906,1123,89,59,251,271,56,30,2,10,2029,0.553474618,148,0.398648649,86
JFreeChart,org.jfree.chart.plot,CrosshairState,141,53,15,1,39,24,14,13,6,13,194,0.273195876,16,0.0625,27
JFreeChart,org.jfree.chart.plot,CategoryCrosshairState,88,29,11,1,26,13,7,6,1,6,117,0.247863248,12,0.083333333,13
JFreeChart,org.jfree.chart.plot,CenterTextMode,0,34,0,0,0,7,0,1,0,1,34,1,0,0,1
JFreeChart,org.jfree.chart.plot,PieLabelLinkStyle,9,67,3,9,4,25,4,8,1,5,76,0.881578947,12,0.75,12
JFreeChart,org.jfree.chart.plot,SeriesRenderingOrder,12,49,4,6,5,17,5,6,1,5,61,0.803278689,10,0.6,11
JFreeChart,org.jfree.chart.imagemap,StandardToolTipTagFragmentGenerator,0,14,0,0,0,4,0,2,0,2,14,1,0,0,2
JFreeChart,org.jfree.chart.imagemap,DynamicDriveToolTipTagFragmentGenerator,48,0,0,0,12,0,3,0,3,0,48,0,0,0,3
JFreeChart,org.jfree.chart.imagemap,StandardURLTagFragmentGenerator,0,13,0,0,0,3,0,2,0,2,13,1,0,0,2
JFreeChart,org.jfree.chart.imagemap,OverLIBToolTipTagFragmentGenerator,0,14,0,0,0,5,0,2,0,2,14,1,0,0,2
JFreeChart,org.jfree.chart.imagemap,ImageMapUtils,125,128,12,22,40,41,12,13,6,2,253,0.505928854,34,0.647058824,25
JFreeChart,org.jfree.chart.editor,DefaultAxisEditor,591,0,22,0,137,0,29,0,18,0,591,0,22,0,29
JFreeChart,org.jfree.chart.editor,DefaultChartEditor,422,0,6,0,101,0,12,0,9,0,422,0,6,0,12
JFreeChart,org.jfree.chart.editor,DefaultPlotEditor,934,0,100,0,262,0,68,0,18,0,934,0,100,0,68
JFreeChart,org.jfree.chart.editor,DefaultLogAxisEditor,156,0,12,0,46,0,13,0,7,0,156,0,12,0,13
JFreeChart,org.jfree.chart.editor,DefaultTitleEditor,385,0,20,0,100,0,21,0,11,0,385,0,20,0,21
JFreeChart,org.jfree.chart.editor,DefaultValueAxisEditor,546,0,32,0,149,0,36,0,20,0,546,0,32,0,36
JFreeChart,org.jfree.chart.editor,DefaultPolarPlotEditor,241,0,12,0,66,0,15,0,9,0,241,0,12,0,15
JFreeChart,org.jfree.chart.editor,DefaultNumberAxisEditor,199,0,12,0,56,0,13,0,7,0,199,0,12,0,13
JFreeChart,org.jfree.chart.editor,DefaultChartEditorFactory,8,0,0,0,3,0,2,0,2,0,8,0,0,0,2
JFreeChart,org.jfree.chart.editor,ChartEditorManager,17,0,0,0,6,0,4,0,4,0,17,0,0,0,4
JFreeChart,org.jfree.chart.urls,CustomPieURLGenerator,13,159,7,17,5,39,8,12,1,7,172,0.924418605,24,0.708333333,20
JFreeChart,org.jfree.chart.urls,StandardXYURLGenerator,58,64,8,6,10,22,7,5,1,4,122,0.524590164,14,0.428571429,12
JFreeChart,org.jfree.chart.urls,StandardCategoryURLGenerator,51,165,9,11,11,43,8,9,2,5,216,0.763888889,20,0.55,17
JFreeChart,org.jfree.chart.urls,TimeSeriesURLGenerator,33,192,5,15,7,45,9,9,4,4,225,0.853333333,20,0.75,18
JFreeChart,org.jfree.chart.urls,StandardXYZURLGenerator,9,0,0,0,2,0,2,0,2,0,9,0,0,0,2
JFreeChart,org.jfree.chart.urls,CustomXYURLGenerator,17,139,10,18,7,39,10,12,1,7,156,0.891025641,28,0.642857143,22
JFreeChart,org.jfree.chart.urls,CustomCategoryURLGenerator,17,139,10,18,7,40,10,12,1,7,156,0.891025641,28,0.642857143,22
JFreeChart,org.jfree.chart.urls,URLUtilities,54,0,0,0,16,0,3,0,3,0,54,0,0,0,3
JFreeChart,org.jfree.chart.urls,StandardPieURLGenerator,28,127,3,11,5,35,3,10,0,6,155,0.819354839,14,0.785714286,13
JFreeChart,org.jfree.data.json,JSONUtils,224,0,20,0,69,0,15,0,5,0,224,0,20,0,15
JFreeChart,org.jfree.chart.title,LegendGraphic,118,497,30,44,31,151,29,47,9,30,615,0.808130081,74,0.594594595,76
JFreeChart,org.jfree.chart.title,Title,29,270,9,19,11,82,12,24,4,18,299,0.903010033,28,0.678571429,36
JFreeChart,org.jfree.chart.title,ImageTitle,405,0,36,0,102,0,29,0,11,0,405,0,36,0,29
JFreeChart,org.jfree.chart.title,DateTitle,10,43,0,0,2,13,1,4,1,4,53,0.811320755,0,0,5
JFreeChart,org.jfree.chart.title,ShortTextTitle,289,12,43,1,66,4,28,2,6,2,301,0.03986711,44,0.022727273,30
JFreeChart,org.jfree.chart.title,PaintScaleLegend,750,314,68,24,169,93,49,27,13,17,1064,0.295112782,92,0.260869565,76
JFreeChart,org.jfree.chart.title,CompositeTitle,73,80,4,6,19,26,7,10,4,8,153,0.522875817,10,0.6,17
JFreeChart,org.jfree.chart.title,LegendItemBlockContainer,9,78,1,3,3,25,4,7,3,6,87,0.896551724,4,0.75,11
JFreeChart,org.jfree.chart.title,TextTitle,507,592,94,56,134,171,72,40,12,25,1099,0.53867152,150,0.373333333,112
JFreeChart,org.jfree.chart.title,LegendTitle,116,596,20,42,34,167,29,37,12,23,712,0.837078652,62,0.677419355,66
JFreeChart,org.jfree.data.xml,ItemHandler,111,0,8,0,33,0,11,0,7,0,111,0,8,0,11
JFreeChart,org.jfree.data.xml,PieDatasetHandler,72,0,8,0,22,0,9,0,5,0,72,0,8,0,9
JFreeChart,org.jfree.data.xml,ValueHandler,98,0,8,0,28,0,10,0,6,0,98,0,8,0,10
JFreeChart,org.jfree.data.xml,KeyHandler,94,0,6,0,24,0,9,0,6,0,94,0,6,0,9
JFreeChart,org.jfree.data.xml,DatasetReader,83,0,0,0,29,0,5,0,5,0,83,0,0,0,5
JFreeChart,org.jfree.data.xml,RootHandler,54,0,8,0,18,0,10,0,6,0,54,0,8,0,10
JFreeChart,org.jfree.data.xml,CategoryDatasetHandler,84,0,8,0,24,0,9,0,5,0,84,0,8,0,9
JFreeChart,org.jfree.data.xml,CategorySeriesHandler,113,0,8,0,30,0,9,0,5,0,113,0,8,0,9
JFreeChart,org.jfree.chart,ChartColor,6,338,0,0,2,59,1,2,1,2,344,0.98255814,0,0,3
JFreeChart,org.jfree.chart,ChartHints.Key,33,0,13,0,7,0,9,0,2,0,33,0,13,0,9
JFreeChart,org.jfree.chart,PaintMap,5,164,0,14,1,48,1,15,1,8,169,0.970414201,14,1,16
JFreeChart,org.jfree.chart,JFreeChart,523,1129,73,103,147,326,82,80,27,47,1652,0.683414044,176,0.585227273,162
JFreeChart,org.jfree.chart,StandardChartTheme,763,1232,93,117,223,381,112,85,46,46,1995,0.61754386,210,0.557142857,197
JFreeChart,org.jfree.chart,ChartTransferable,207,0,12,0,61,0,13,0,7,0,207,0,12,0,13
JFreeChart,org.jfree.chart,HashUtils,136,185,23,19,33,42,18,17,1,13,321,0.576323988,42,0.452380952,35
JFreeChart,org.jfree.chart,PolarChartPanel,243,0,24,0,75,0,19,0,7,0,243,0,24,0,19
JFreeChart,org.jfree.chart,ChartFrame,36,0,2,0,11,0,4,0,3,0,36,0,2,0,4
JFreeChart,org.jfree.chart,StrokeMap,9,160,0,14,3,46,2,14,2,7,169,0.946745562,14,1,16
JFreeChart,org.jfree.chart,ChartUtils,402,0,8,0,128,0,32,0,28,0,402,0,8,0,32
JFreeChart,org.jfree.chart,JFreeChart.new RenderingHints.Key() {...},3,4,0,0,1,1,1,1,1,1,7,0.571428571,0,0,2
JFreeChart,org.jfree.chart,LegendItem,96,689,8,44,38,220,18,66,10,48,785,0.877707006,52,0.846153846,84
JFreeChart,org.jfree.chart,LegendItemCollection,6,64,1,5,2,19,2,9,1,7,70,0.914285714,6,0.833333333,11
JFreeChart,org.jfree.chart,ChartMouseEvent,22,0,0,0,8,0,4,0,4,0,22,0,0,0,4
JFreeChart,org.jfree.chart,ChartRenderingInfo,2,141,4,12,1,43,4,16,0,12,143,0.986013986,16,0.75,20
JFreeChart,org.jfree.chart,ChartPanel,2955,1223,358,52,811,351,288,38,91,30,4178,0.292723791,410,0.126829268,326
JFreeChart,org.jfree.chart,ChartHints,11,0,0,0,2,0,1,0,1,0,11,0,0,0,1
JFreeChart,org.jfree.chart,LegendRenderingOrder,57,0,10,0,21,0,10,0,5,0,57,0,10,0,10
JFreeChart,org.jfree.chart,StandardChartTheme.new StandardChartTheme() {...},5,0,0,0,2,0,2,0,2,0,5,0,0,0,2
JFreeChart,org.jfree.chart,MouseWheelHandler,105,13,14,0,33,5,11,1,4,1,118,0.110169492,14,0,12
JFreeChart,org.jfree.chart,ChartFactory,1396,1216,150,52,334,349,116,41,27,29,2612,0.465543645,202,0.257425743,157
JFreeChart,org.jfree.chart.needle,PinNeedle,128,18,9,3,25,6,8,3,2,3,146,0.123287671,12,0.25,11
JFreeChart,org.jfree.chart.needle,MiddlePinNeedle,133,20,10,4,26,6,9,3,2,3,153,0.130718954,14,0.285714286,12
JFreeChart,org.jfree.chart.needle,ShipNeedle,84,20,8,4,18,6,8,3,2,3,104,0.192307692,12,0.333333333,11
JFreeChart,org.jfree.chart.needle,PointerNeedle,139,18,13,3,36,6,10,3,2,3,157,0.114649682,16,0.1875,13
JFreeChart,org.jfree.chart.needle,ArrowNeedle,142,34,13,5,33,12,10,4,2,3,176,0.193181818,18,0.277777778,14
JFreeChart,org.jfree.chart.needle,MeterNeedle,144,187,10,20,39,63,21,20,13,13,331,0.564954683,30,0.666666667,41
JFreeChart,org.jfree.chart.needle,PlumNeedle,84,18,7,3,20,6,7,3,2,3,102,0.176470588,10,0.3,10
JFreeChart,org.jfree.chart.needle,WindNeedle,69,18,8,4,17,6,8,2,2,2,87,0.206896552,12,0.333333333,10
JFreeChart,org.jfree.chart.needle,LineNeedle,53,16,6,2,12,5,6,3,2,3,69,0.231884058,8,0.25,9
JFreeChart,org.jfree.chart.needle,LongNeedle,189,19,14,2,50,7,10,3,2,3,208,0.091346154,16,0.125,13
JFreeChart,org.jfree.chart.encoders,SunPNGEncoderAdapter,32,0,0,0,12,0,7,0,7,0,32,0,0,0,7
JFreeChart,org.jfree.chart.encoders,EncoderUtil,71,0,0,0,27,0,9,0,9,0,71,0,0,0,9
JFreeChart,org.jfree.chart.encoders,SunJPEGEncoderAdapter,86,0,4,0,28,0,9,0,7,0,86,0,4,0,9
JFreeChart,org.jfree.chart.encoders,ImageEncoderFactory,92,0,2,0,31,0,9,0,8,0,92,0,2,0,9
JFreeChart,org.jfree.data.io,CSV,212,0,20,0,59,0,16,0,6,0,212,0,20,0,16
JFreeChart,org.jfree.chart.labels,IntervalXYItemLabelGenerator,255,24,29,3,61,9,21,4,6,3,279,0.086021505,32,0.09375,25
JFreeChart,org.jfree.chart.labels,StandardPieToolTipGenerator,10,26,0,0,3,10,2,5,2,5,36,0.722222222,0,0,7
JFreeChart,org.jfree.chart.labels,IntervalXYToolTipGenerator,279,0,32,0,70,0,25,0,9,0,279,0,32,0,25
JFreeChart,org.jfree.chart.labels,StandardXYToolTipGenerator,14,46,1,3,4,16,3,8,2,7,60,0.766666667,4,0.75,11
JFreeChart,org.jfree.chart.labels,IntervalCategoryToolTipGenerator,98,27,11,3,22,10,7,5,1,4,125,0.216,14,0.214285714,12
JFreeChart,org.jfree.chart.labels,StandardCrosshairLabelGenerator,38,49,4,8,12,18,7,6,3,4,87,0.563218391,12,0.666666667,13
JFreeChart,org.jfree.chart.labels,IntervalCategoryItemLabelGenerator,96,15,10,0,21,6,6,3,1,3,111,0.135135135,10,0,9
JFreeChart,org.jfree.chart.labels,AbstractXYItemLabelGenerator,72,233,10,22,19,65,13,19,4,12,305,0.763934426,32,0.6875,32
JFreeChart,org.jfree.chart.labels,BoxAndWhiskerXYToolTipGenerator,106,22,6,2,19,8,5,3,1,3,128,0.171875,8,0.25,8
JFreeChart,org.jfree.chart.labels,BubbleXYItemLabelGenerator,101,101,9,9,26,31,9,10,3,7,202,0.5,18,0.5,19
JFreeChart,org.jfree.chart.labels,AbstractPieItemLabelGenerator,5,183,4,18,2,55,5,15,1,8,188,0.973404255,22,0.818181818,20
JFreeChart,org.jfree.chart.labels,StandardCategorySeriesLabelGenerator,2,71,1,5,1,25,1,9,0,7,73,0.97260274,6,0.833333333,10
JFreeChart,org.jfree.chart.labels,StandardPieSectionLabelGenerator,28,75,1,5,8,25,5,9,4,7,103,0.72815534,6,0.833333333,14
JFreeChart,org.jfree.chart.labels,BoxAndWhiskerToolTipGenerator,89,20,4,2,17,7,4,3,1,3,109,0.183486239,6,0.333333333,7
JFreeChart,org.jfree.chart.labels,AbstractCategoryItemLabelGenerator,35,220,7,15,10,64,10,14,4,9,255,0.862745098,22,0.681818182,24
JFreeChart,org.jfree.chart.labels,MultipleXYSeriesLabelGenerator,114,123,10,10,30,38,10,9,3,6,237,0.518987342,20,0.5,19
JFreeChart,org.jfree.chart.labels,CustomXYToolTipGenerator,18,126,14,14,4,35,13,9,1,7,144,0.875,28,0.5,22
JFreeChart,org.jfree.chart.labels,SymbolicXYItemLabelGenerator,95,18,10,2,25,7,9,4,3,4,113,0.159292035,12,0.166666667,13
JFreeChart,org.jfree.chart.labels,StandardCategoryItemLabelGenerator,6,35,0,4,2,12,1,7,1,5,41,0.853658537,4,1,8
JFreeChart,org.jfree.chart.labels,StandardXYZToolTipGenerator,113,64,8,8,28,24,10,7,5,4,177,0.361581921,16,0.5,17
JFreeChart,org.jfree.chart.labels,ItemLabelPosition,18,79,3,9,7,25,7,7,4,4,97,0.81443299,12,0.75,14
JFreeChart,org.jfree.chart.labels,ItemLabelAnchor,65,271,23,33,43,95,23,10,0,5,336,0.806547619,56,0.589285714,33
JFreeChart,org.jfree.chart.labels,StandardCategoryToolTipGenerator,8,27,1,3,2,10,2,5,1,4,35,0.771428571,4,0.75,7
JFreeChart,org.jfree.chart.labels,HighLowItemLabelGenerator,136,83,18,10,33,27,14,7,2,5,219,0.378995434,28,0.357142857,21
JFreeChart,org.jfree.chart.labels,StandardXYSeriesLabelGenerator,2,71,1,5,1,25,1,9,0,7,73,0.97260274,6,0.833333333,10
JFreeChart,org.jfree.chart.labels,StandardXYItemLabelGenerator,20,39,1,3,6,15,4,7,3,6,59,0.661016949,4,0.75,11
JFreeChart,org.jfree.chart.axis,DateTickUnit,78,197,8,22,18,50,14,18,6,11,275,0.716363636,30,0.733333333,32
JFreeChart,org.jfree.chart.axis,TickUnit,12,86,5,11,6,25,6,10,1,7,98,0.87755102,16,0.6875,16
JFreeChart,org.jfree.chart.axis,AxisLocation,45,85,11,11,20,29,9,10,2,6,130,0.653846154,22,0.5,19
JFreeChart,org.jfree.chart.axis,ModuloAxis,462,96,38,8,102,24,35,5,13,4,558,0.172043011,46,0.173913043,40
JFreeChart,org.jfree.chart.axis,DateAxis.DefaultTimeline,15,16,3,3,7,7,7,4,4,4,31,0.516129032,6,0.5,11
JFreeChart,org.jfree.chart.axis,MonthDateFormat,67,131,5,13,16,34,9,10,5,5,198,0.661616162,18,0.722222222,19
JFreeChart,org.jfree.chart.axis,NumberAxis,257,1159,43,105,75,311,45,68,6,33,1416,0.818502825,148,0.709459459,113
JFreeChart,org.jfree.chart.axis,ValueTick,6,58,3,5,3,16,3,6,0,5,64,0.90625,8,0.625,9
JFreeChart,org.jfree.chart.axis,AxisCollection,8,69,3,5,2,22,2,8,0,6,77,0.896103896,8,0.625,10
JFreeChart,org.jfree.chart.axis,DateAxis,708,2144,87,131,184,550,77,84,12,40,2852,0.751753156,218,0.600917431,161
JFreeChart,org.jfree.chart.axis,TickUnits,43,85,5,5,12,22,7,7,3,6,128,0.6640625,10,0.5,14
JFreeChart,org.jfree.chart.axis,NumberTickUnitSource,39,322,16,46,13,85,16,27,0,12,361,0.891966759,62,0.741935484,43
JFreeChart,org.jfree.chart.axis,LogAxis,784,724,81,45,196,189,74,29,18,22,1508,0.480106101,126,0.357142857,103
JFreeChart,org.jfree.chart.axis,CompassFormat,236,0,4,0,20,0,9,0,7,0,236,0,4,0,9
JFreeChart,org.jfree.chart.axis,SymbolAxis,752,137,93,11,222,47,61,13,13,9,889,0.154105737,104,0.105769231,74
JFreeChart,org.jfree.chart.axis,CategoryTick,5,91,2,10,2,23,3,9,1,5,96,0.947916667,12,0.833333333,12
JFreeChart,org.jfree.chart.axis,Axis,527,1259,61,103,126,385,54,102,6,68,1786,0.704927212,164,0.62804878,156
JFreeChart,org.jfree.chart.axis,PeriodAxisLabelInfo,31,257,2,18,11,71,10,17,8,9,288,0.892361111,20,0.9,27
JFreeChart,org.jfree.chart.axis,ExtendedCategoryAxis,73,117,14,8,19,34,11,11,3,8,190,0.615789474,22,0.363636364,22
JFreeChart,org.jfree.chart.axis,SubCategoryAxis,286,263,34,20,82,74,26,15,2,12,549,0.479052823,54,0.37037037,41
JFreeChart,org.jfree.chart.axis,CategoryAnchor,12,56,5,7,5,20,4,7,0,5,68,0.823529412,12,0.583333333,11
JFreeChart,org.jfree.chart.axis,DateTickMarkPosition,8,60,3,9,3,22,2,9,0,5,68,0.882352941,12,0.75,11
JFreeChart,org.jfree.chart.axis,TickType,11,49,4,6,4,17,4,6,1,4,60,0.816666667,10,0.6,10
JFreeChart,org.jfree.chart.axis,MarkerAxisBand,199,103,9,13,50,28,10,8,4,3,302,0.341059603,22,0.590909091,18
JFreeChart,org.jfree.chart.axis,NumberTick,3,27,0,0,1,6,1,2,1,2,30,0.9,0,0,3
JFreeChart,org.jfree.chart.axis,CategoryLabelPosition,4,164,2,14,2,48,2,18,0,12,168,0.976190476,16,0.875,20
JFreeChart,org.jfree.chart.axis,CategoryLabelWidthType,4,56,2,8,2,20,2,8,0,5,60,0.933333333,10,0.8,10
JFreeChart,org.jfree.chart.axis,ValueAxis,567,1247,93,117,159,362,89,86,19,51,1814,0.687431092,210,0.557142857,175
JFreeChart,org.jfree.chart.axis,CyclicNumberAxis,1456,156,191,15,383,56,118,20,21,14,1612,0.096774194,206,0.072815534,138
JFreeChart,org.jfree.chart.axis,StandardTickUnitSource,49,13,1,1,12,5,5,3,4,3,62,0.209677419,2,0.5,8
JFreeChart,org.jfree.chart.axis,NumberTickUnit,16,75,2,8,2,24,3,9,1,6,91,0.824175824,10,0.8,12
JFreeChart,org.jfree.chart.axis,DateTick,7,51,2,4,3,14,3,5,1,4,58,0.879310345,6,0.666666667,8
JFreeChart,org.jfree.chart.axis,AxisSpace,195,269,26,22,48,71,21,22,5,14,464,0.579741379,48,0.458333333,43
JFreeChart,org.jfree.chart.axis,LogTick,15,0,0,0,4,0,2,0,2,0,15,0,0,0,2
JFreeChart,org.jfree.chart.axis,CyclicNumberAxis.CycleBoundTick,11,0,0,0,3,0,1,0,1,0,11,0,0,0,1
JFreeChart,org.jfree.chart.axis,CategoryAxis,385,1504,70,116,98,410,66,81,10,44,1889,0.79618846,186,0.623655914,147
JFreeChart,org.jfree.chart.axis,DateTickUnitType,4,121,2,18,2,43,2,14,0,6,125,0.968,20,0.9,16
JFreeChart,org.jfree.chart.axis,AxisState,39,53,8,0,16,19,7,10,3,10,92,0.576086957,8,0,17
JFreeChart,org.jfree.chart.axis,LogarithmicAxis,1186,265,229,25,296,73,136,20,14,15,1451,0.182632667,254,0.098425197,156
JFreeChart,org.jfree.chart.axis,Tick,7,82,2,10,3,26,3,11,1,7,89,0.921348315,12,0.833333333,14
JFreeChart,org.jfree.chart.axis,PeriodAxis,1254,486,113,25,301,138,82,33,24,22,1740,0.279310345,138,0.18115942,115
JFreeChart,org.jfree.chart.axis,QuarterDateFormat,69,116,4,6,20,24,7,6,4,4,185,0.627027027,10,0.6,13
JFreeChart,org.jfree.chart.axis,CategoryLabelPositions,117,326,6,14,39,121,10,12,5,7,443,0.735891648,20,0.7,22
JFreeChart,org.jfree.chart.axis,AxisLabelLocation,24,56,5,7,8,20,5,7,1,5,80,0.7,12,0.583333333,12
JFreeChart,org.jfree.data.general,AbstractDataset,18,107,4,4,8,32,6,12,3,11,125,0.856,8,0.5,18
JFreeChart,org.jfree.data.general,DatasetGroup,21,23,3,3,9,8,6,2,3,2,44,0.522727273,6,0.5,8
JFreeChart,org.jfree.data.general,Series,38,224,7,13,14,64,11,21,5,17,262,0.854961832,20,0.65,32
JFreeChart,org.jfree.data.general,DefaultPieDataset,83,138,9,13,27,40,15,15,7,12,221,0.624434389,22,0.590909091,30
JFreeChart,org.jfree.data.general,DefaultHeatMapDataset,78,188,12,30,15,51,15,21,3,12,266,0.706766917,42,0.714285714,36
JFreeChart,org.jfree.data.general,HeatMapUtils,125,0,8,0,27,0,8,0,4,0,125,0,8,0,8
JFreeChart,org.jfree.data.general,DefaultValueDataset,39,20,6,0,10,8,6,4,3,4,59,0.338983051,6,0,10
JFreeChart,org.jfree.data.general,WaferMapDataset,211,0,20,0,56,0,29,0,19,0,211,0,20,0,29
JFreeChart,org.jfree.data.general,DatasetUtils,752,2853,150,406,192,712,121,214,10,47,3605,0.791400832,556,0.730215827,335
JFreeChart,org.jfree.data.general,AbstractSeriesDataset,0,26,0,4,0,9,0,5,0,3,26,1,4,1,5
JFreeChart,org.jfree.data.general,SeriesChangeEvent,0,4,0,0,0,2,0,1,0,1,4,1,0,0,1
JFreeChart,org.jfree.data.general,SeriesException,0,4,0,0,0,2,0,1,0,1,4,1,0,0,1
JFreeChart,org.jfree.data.general,DefaultKeyedValuesDataset,0,3,0,0,0,1,0,1,0,1,3,1,0,0,1
JFreeChart,org.jfree.data.general,DatasetChangeEvent,0,10,0,0,0,4,0,2,0,2,10,1,0,0,2
JFreeChart,org.jfree.data.general,DefaultKeyedValueDataset,32,99,12,10,9,31,11,10,2,8,131,0.755725191,22,0.454545455,21
JFreeChart,org.jfree.data.general,DefaultKeyedValues2DDataset,0,3,0,0,0,1,0,1,0,1,3,1,0,0,1
JFreeChart,org.jfree.data.time.ohlc,OHLCSeries,21,49,1,3,6,11,2,6,1,5,70,0.7,4,0.75,8
JFreeChart,org.jfree.data.time.ohlc,OHLC,4,94,2,10,2,28,2,11,0,7,98,0.959183673,12,0.833333333,13
JFreeChart,org.jfree.data.time.ohlc,OHLCSeriesCollection,178,179,10,16,40,51,24,17,17,11,357,0.50140056,26,0.615384615,41
JFreeChart,org.jfree.data.time.ohlc,OHLCItem,11,51,4,4,5,15,5,6,1,6,62,0.822580645,8,0.5,11
JFreeChart,org.jfree.chart.resources,JFreeChartResources,61,0,0,0,9,0,3,0,3,0,61,0,0,0,3
JFreeChart,org.jfree.data.jdbc,JDBCPieDataset,133,0,13,0,54,0,13,0,6,0,133,0,13,0,13
JFreeChart,org.jfree.data.jdbc,JDBCCategoryDataset,198,0,24,0,70,0,20,0,7,0,198,0,24,0,20
JFreeChart,org.jfree.data.jdbc,JDBCXYDataset,434,0,52,0,128,0,45,0,18,0,434,0,52,0,45
JFreeChart,org.jfree.data.category,DefaultCategoryDataset,20,223,1,19,8,64,4,31,3,22,243,0.917695473,20,0.95,35
JFreeChart,org.jfree.data.category,DefaultIntervalCategoryDataset,161,588,46,74,49,156,44,48,2,30,749,0.785046729,120,0.616666667,92
JFreeChart,org.jfree.data.category,SlidingCategoryDataset,48,205,7,23,11,52,13,21,6,13,253,0.81027668,30,0.766666667,34
JFreeChart,org.jfree.data.category,CategoryToPieDataset,62,223,23,35,20,66,19,22,1,11,285,0.78245614,58,0.603448276,41
JFreeChart,org.jfree.chart.panel,AbstractOverlay,32,30,3,1,9,9,4,3,2,3,62,0.483870968,4,0.25,7
JFreeChart,org.jfree.chart.panel,CrosshairOverlay,909,84,145,5,268,25,89,6,15,5,993,0.084592145,150,0.033333333,95
JFreeChart,org.jfree.chart.renderer,LookupPaintScale.PaintItem,8,69,4,8,4,24,4,7,0,5,77,0.896103896,12,0.666666667,11
JFreeChart,org.jfree.chart.renderer,LookupPaintScale,11,239,4,30,4,65,4,24,0,11,250,0.956,34,0.882352941,28
JFreeChart,org.jfree.chart.renderer,AreaRendererEndType,11,61,5,7,5,23,4,7,0,5,72,0.847222222,12,0.583333333,11
JFreeChart,org.jfree.chart.renderer,DefaultPolarItemRenderer,720,345,89,29,210,100,82,16,24,15,1065,0.323943662,118,0.245762712,98
JFreeChart,org.jfree.chart.renderer,RendererState,0,35,0,4,0,14,0,7,0,5,35,1,4,1,7
JFreeChart,org.jfree.chart.renderer,RendererUtils,17,365,6,56,5,97,7,28,1,3,382,0.955497382,62,0.903225806,35
JFreeChart,org.jfree.chart.renderer,Outlier,99,66,16,6,15,20,12,10,3,8,165,0.4,22,0.272727273,22
JFreeChart,org.jfree.chart.renderer,WaferMapRenderer,474,0,56,0,120,0,44,0,15,0,474,0,56,0,44
JFreeChart,org.jfree.chart.renderer,NotOutlierException,4,0,0,0,2,0,1,0,1,0,4,0,0,0,1
JFreeChart,org.jfree.chart.renderer,AbstractRenderer,693,1848,127,177,174,602,131,179,34,124,2541,0.727272727,304,0.582236842,310
JFreeChart,org.jfree.chart.renderer,OutlierListCollection,68,24,8,0,20,8,8,4,4,4,92,0.260869565,8,0,12
JFreeChart,org.jfree.chart.renderer,OutlierList,93,0,4,0,28,0,11,0,9,0,93,0,4,0,11
JFreeChart,org.jfree.chart.renderer,GrayPaintScale,31,115,3,13,9,32,4,14,1,9,146,0.787671233,16,0.8125,18
JFreeChart,org.jfree.chart.util,CloneUtils,46,38,4,4,11,9,4,3,2,1,84,0.452380952,8,0.5,7
JFreeChart,org.jfree.chart.util,Args,26,40,1,5,4,9,2,5,1,3,66,0.606060606,6,0.833333333,7
JFreeChart,org.jfree.chart.util,SortOrder,3,34,0,0,1,8,1,2,1,2,37,0.918918919,0,0,3
JFreeChart,org.jfree.chart.util,XYCoordinateType,14,54,6,6,6,19,5,6,0,5,68,0.794117647,12,0.5,11
JFreeChart,org.jfree.chart.util,StringUtils,43,0,4,0,9,0,5,0,3,0,43,0,4,0,5
JFreeChart,org.jfree.chart.util,BooleanList,5,20,1,1,2,7,2,4,1,4,25,0.8,2,0.5,6
JFreeChart,org.jfree.chart.util,ObjectList,4,16,0,0,2,6,1,4,1,4,20,0.8,0,0,5
JFreeChart,org.jfree.chart.util,HMSNumberFormat,9,60,0,0,2,12,2,2,2,2,69,0.869565217,0,0,4
JFreeChart,org.jfree.chart.util,PaintAlpha,471,0,36,0,92,0,28,0,10,0,471,0,36,0,28
JFreeChart,org.jfree.chart.util,SerialUtils,196,760,29,79,48,239,29,40,0,13,956,0.794979079,108,0.731481481,69
JFreeChart,org.jfree.chart.util,DefaultShadowGenerator,383,62,22,8,79,18,25,3,11,2,445,0.139325843,30,0.266666667,28
JFreeChart,org.jfree.chart.util,Rotation,3,42,0,0,1,10,1,3,1,3,45,0.933333333,0,0,4
JFreeChart,org.jfree.chart.util,DirectionalGradientPaintTransformer,166,0,20,0,33,0,12,0,2,0,166,0,20,0,12
JFreeChart,org.jfree.chart.util,ResourceBundleWrapper,58,5,7,1,15,2,7,1,3,1,63,0.079365079,8,0.125,8
JFreeChart,org.jfree.chart.util,LineUtils,113,195,18,22,25,48,16,7,2,1,308,0.633116883,40,0.55,23
JFreeChart,org.jfree.chart.util,StrokeList,38,55,9,5,13,19,8,7,1,7,93,0.591397849,14,0.357142857,15
JFreeChart,org.jfree.chart.util,ArrayUtils,152,68,41,17,42,16,26,8,3,2,220,0.309090909,58,0.293103448,34
JFreeChart,org.jfree.chart.util,AbstractObjectList,30,214,6,28,7,62,7,23,1,12,244,0.87704918,34,0.823529412,30
JFreeChart,org.jfree.chart.util,LogFormat,82,108,7,11,20,31,11,9,6,5,190,0.568421053,18,0.611111111,20
JFreeChart,org.jfree.chart.util,ShapeList,36,76,8,8,12,23,7,9,1,7,112,0.678571429,16,0.5,16
JFreeChart,org.jfree.chart.util,ShapeUtils,642,254,76,48,133,65,63,21,11,11,896,0.283482143,124,0.387096774,84
JFreeChart,org.jfree.chart.util,HexNumberFormat,67,0,4,0,19,0,9,0,7,0,67,0,4,0,9
JFreeChart,org.jfree.chart.util,UnitType,3,34,0,0,1,8,1,2,1,2,37,0.918918919,0,0,3
JFreeChart,org.jfree.chart.util,RelativeDateFormat,46,437,8,32,17,119,15,33,7,21,483,0.904761905,40,0.8,48
JFreeChart,org.jfree.chart.util,PaintUtils,217,75,58,20,49,18,35,7,2,1,292,0.256849315,78,0.256410256,42
JFreeChart,org.jfree.chart.util,TableOrder,3,34,0,0,1,8,1,2,1,2,37,0.918918919,0,0,3
JFreeChart,org.jfree.chart.util,PaintList,12,99,5,13,5,31,6,10,1,6,111,0.891891892,18,0.722222222,16
JFreeChart,org.jfree.chart.util,ExportUtils,381,0,8,0,91,0,11,0,7,0,381,0,8,0,11
JFreeChart,org.jfree.chart.util,ObjectUtils,37,76,4,14,10,27,4,9,0,4,113,0.672566372,18,0.777777778,13
JFreeChart,org.jfree.chart.util,AttrStringUtils,490,11,92,0,126,3,60,1,14,1,501,0.021956088,92,0,61
JFreeChart,org.jfree.chart.entity,StandardEntityCollection,46,82,6,4,11,22,8,8,4,7,128,0.640625,10,0.4,16
JFreeChart,org.jfree.chart.entity,TitleEntity,98,25,12,0,30,8,13,3,7,3,123,0.203252033,12,0,16
JFreeChart,org.jfree.chart.entity,ChartEntity,278,93,32,8,67,34,27,13,10,10,371,0.250673854,40,0.2,40
JFreeChart,org.jfree.chart.entity,XYAnnotationEntity,44,0,8,0,16,0,8,0,4,0,44,0,8,0,8
JFreeChart,org.jfree.chart.entity,CategoryItemEntity,53,49,5,5,17,13,12,2,7,2,102,0.480392157,10,0.5,14
JFreeChart,org.jfree.chart.entity,PlotEntity,111,12,12,0,34,4,15,1,9,1,123,0.097560976,12,0,16
JFreeChart,org.jfree.chart.entity,PieSectionEntity,53,77,2,10,12,26,8,10,6,6,130,0.592307692,12,0.833333333,18
JFreeChart,org.jfree.chart.entity,LegendItemEntity,26,49,3,7,7,16,6,7,3,5,75,0.653333333,10,0.7,13
JFreeChart,org.jfree.chart.entity,CategoryLabelEntity,48,30,2,4,12,9,5,3,3,2,78,0.384615385,6,0.666666667,8
JFreeChart,org.jfree.chart.entity,XYItemEntity,34,54,2,8,8,18,7,7,5,4,88,0.613636364,10,0.8,14
JFreeChart,org.jfree.chart.entity,TickLabelEntity,0,6,0,0,0,2,0,1,0,1,6,1,0,0,1
JFreeChart,org.jfree.chart.entity,JFreeChartEntity,98,25,12,0,30,8,13,3,7,3,123,0.203252033,12,0,16
JFreeChart,org.jfree.chart.entity,AxisEntity,98,25,12,0,30,8,13,3,7,3,123,0.203252033,12,0,16
JFreeChart,org.jfree.data.gantt,XYTaskDataset,234,84,15,9,51,29,32,10,23,7,318,0.264150943,24,0.375,42
JFreeChart,org.jfree.data.gantt,SlidingGanttCategoryDataset,451,88,32,12,89,30,46,9,27,6,539,0.163265306,44,0.272727273,55
JFreeChart,org.jfree.data.gantt,TaskSeries,22,96,2,10,7,30,5,11,3,7,118,0.813559322,12,0.833333333,16
JFreeChart,org.jfree.data.gantt,Task,2,136,1,11,1,44,1,20,0,15,138,0.985507246,12,0.916666667,21
JFreeChart,org.jfree.data.gantt,TaskSeriesCollection,53,599,11,49,17,160,13,54,4,33,652,0.918711656,60,0.816666667,67
JFreeChart,org.jfree.chart.date,SpreadsheetDate,173,232,42,22,31,61,36,16,10,10,405,0.572839506,64,0.34375,52
JFreeChart,org.jfree.chart.date,SerialDate,385,393,48,19,108,50,55,17,25,9,778,0.505141388,67,0.28358209,72
JFreeChart,org.jfree.data.time,DynamicTimeSeriesCollection,914,0,92,0,213,0,89,0,42,0,914,0,92,0,89
JFreeChart,org.jfree.data.time,Year,31,197,5,13,9,54,5,22,1,17,228,0.864035088,18,0.722222222,27
JFreeChart,org.jfree.data.time,Week,302,297,44,18,92,80,35,20,9,15,599,0.495826377,62,0.290322581,55
JFreeChart,org.jfree.data.time,Minute,138,304,22,10,37,75,16,21,2,19,442,0.687782805,32,0.3125,37
JFreeChart,org.jfree.data.time,Second,184,284,32,10,47,64,22,18,3,16,468,0.606837607,42,0.238095238,40
JFreeChart,org.jfree.data.time,Day,27,280,5,9,11,82,5,25,1,22,307,0.912052117,14,0.642857143,30
JFreeChart,org.jfree.data.time,TimePeriodValue,57,72,11,9,10,23,10,9,2,7,129,0.558139535,20,0.45,19
JFreeChart,org.jfree.data.time,DynamicTimeSeriesCollection.ValueSequence,39,0,2,0,10,0,5,0,4,0,39,0,2,0,5
JFreeChart,org.jfree.data.time,MovingAverage,304,109,39,15,75,32,28,6,6,1,413,0.263922518,54,0.277777778,34
JFreeChart,org.jfree.data.time,TimeTableXYDataset,233,167,24,12,58,48,33,17,18,14,400,0.4175,36,0.333333333,50
JFreeChart,org.jfree.data.time,TimePeriodValuesCollection,215,209,19,19,54,62,25,16,13,9,424,0.492924528,38,0.5,41
JFreeChart,org.jfree.data.time,Millisecond,109,292,23,11,35,65,17,18,2,16,401,0.728179551,34,0.323529412,35
JFreeChart,org.jfree.data.time,RegularTimePeriod,40,129,10,10,12,28,8,11,1,8,169,0.763313609,20,0.5,19
JFreeChart,org.jfree.data.time,TimePeriodValues,94,489,8,44,16,142,7,46,1,26,583,0.838765009,52,0.846153846,53
JFreeChart,org.jfree.data.time,TimePeriodFormatException,0,4,0,0,0,2,0,1,0,1,4,1,0,0,1
JFreeChart,org.jfree.data.time,TimeSeries,277,1288,42,150,70,350,45,109,8,50,1565,0.823003195,192,0.78125,154
JFreeChart,org.jfree.data.time,SimpleTimePeriod,17,150,4,18,6,40,6,14,2,7,167,0.898203593,22,0.818181818,20
JFreeChart,org.jfree.data.time,TimePeriodAnchor,13,59,4,8,5,21,4,8,1,5,72,0.819444444,12,0.666666667,12
JFreeChart,org.jfree.data.time,Hour,77,322,14,14,20,82,13,24,2,21,399,0.807017544,28,0.5,37
JFreeChart,org.jfree.data.time,FixedMillisecond,79,61,11,5,27,20,18,7,10,7,140,0.435714286,16,0.3125,25
JFreeChart,org.jfree.data.time,Month,79,387,17,35,22,107,17,32,1,22,466,0.830472103,52,0.673076923,49
JFreeChart,org.jfree.data.time,TimeSeriesCollection,148,592,21,51,37,158,25,49,9,29,740,0.8,72,0.708333333,74
JFreeChart,org.jfree.data.time,TimeSeriesTableModel,143,0,32,0,53,0,27,0,11,0,143,0,32,0,27
JFreeChart,org.jfree.data.time,TimeSeriesDataItem,10,103,4,10,5,31,4,12,0,9,113,0.911504425,14,0.714285714,16
JFreeChart,org.jfree.data.time,DateRange,29,59,0,0,5,14,2,7,2,7,88,0.670454545,0,0,9
JFreeChart,org.jfree.data.time,Quarter,86,371,16,18,21,83,15,24,2,20,457,0.811816193,34,0.529411765,39
JFreeChart,org.jfree.chart.renderer.category,MinMaxCategoryRenderer,241,328,22,14,58,76,24,13,9,10,569,0.576449912,36,0.388888889,37
JFreeChart,org.jfree.chart.renderer.category,LevelRenderer,171,342,25,23,37,96,25,12,3,10,513,0.666666667,48,0.479166667,37
JFreeChart,org.jfree.chart.renderer.category,CategoryStepRenderer.State,9,0,0,0,3,0,1,0,1,0,9,0,0,0,1
JFreeChart,org.jfree.chart.renderer.category,LayeredBarRenderer,447,283,80,22,110,75,53,5,2,5,730,0.387671233,102,0.215686275,58
JFreeChart,org.jfree.chart.renderer.category,StandardBarPainter,198,17,31,3,57,8,19,4,3,3,215,0.079069767,34,0.088235294,23
JFreeChart,org.jfree.chart.renderer.category,StatisticalBarRenderer,232,567,63,41,63,154,47,17,2,10,799,0.709637046,104,0.394230769,64
JFreeChart,org.jfree.chart.renderer.category,DefaultCategoryItemRenderer,0,3,0,0,0,1,0,1,0,1,3,1,0,0,1
JFreeChart,org.jfree.chart.renderer.category,StackedAreaRenderer,761,46,57,7,177,18,36,7,6,5,807,0.057001239,64,0.109375,43
JFreeChart,org.jfree.chart.renderer.category,BarRenderer,613,920,140,78,178,270,94,65,8,42,1533,0.600130463,218,0.357798165,159
JFreeChart,org.jfree.chart.renderer.category,LineAndShapeRenderer,177,648,43,59,51,191,42,44,4,31,825,0.785454545,102,0.578431373,86
JFreeChart,org.jfree.chart.renderer.category,ScatterRenderer,374,150,47,15,105,54,37,18,12,12,524,0.286259542,62,0.241935484,55
JFreeChart,org.jfree.chart.renderer.category,StatisticalLineAndShapeRenderer,207,401,36,40,60,109,35,15,3,9,608,0.659539474,76,0.526315789,50
JFreeChart,org.jfree.chart.renderer.category,GroupedStackedBarRenderer,136,343,39,29,33,102,31,10,0,7,479,0.716075157,68,0.426470588,41
JFreeChart,org.jfree.chart.renderer.category,AreaRenderer,333,140,39,11,88,41,25,7,2,5,473,0.295983087,50,0.22,32
JFreeChart,org.jfree.chart.renderer.category,CategoryStepRenderer,292,122,32,10,68,36,25,5,5,4,414,0.29468599,42,0.238095238,30
JFreeChart,org.jfree.chart.renderer.category,MinMaxCategoryRenderer.new Icon() {...},10,53,2,2,3,8,4,2,2,2,63,0.841269841,4,0.5,6
JFreeChart,org.jfree.chart.renderer.category,MinMaxCategoryRenderer.new Icon() {...},50,21,4,0,12,1,5,1,3,1,71,0.295774648,4,0,6
JFreeChart,org.jfree.chart.renderer.category,CategoryItemRendererState,32,60,5,5,11,21,7,9,3,8,92,0.652173913,10,0.5,16
JFreeChart,org.jfree.chart.renderer.category,AbstractCategoryItemRenderer,977,911,121,91,286,302,94,71,11,48,1888,0.482521186,212,0.429245283,165
JFreeChart,org.jfree.chart.renderer.category,BoxAndWhiskerRenderer,648,989,73,77,139,260,70,35,12,18,1637,0.60415394,150,0.513333333,105
JFreeChart,org.jfree.chart.renderer.category,StackedBarRenderer,380,68,77,7,106,25,43,8,3,6,448,0.151785714,84,0.083333333,51
JFreeChart,org.jfree.chart.renderer.category,IntervalBarRenderer,81,169,15,15,21,51,14,6,0,5,250,0.676,30,0.5,20
JFreeChart,org.jfree.chart.renderer.category,WaterfallBarRenderer,287,308,41,21,84,86,28,18,5,10,595,0.517647059,62,0.338709677,46
JFreeChart,org.jfree.chart.renderer.category,GradientBarPainter,110,595,28,22,35,121,19,15,0,9,705,0.843971631,50,0.44,34
JFreeChart,org.jfree.chart.renderer.category,GanttRenderer,553,338,61,25,130,108,41,18,3,13,891,0.379349046,86,0.290697674,59
JFreeChart,org.jfree.chart.renderer.xy,WindItemRenderer,252,6,0,0,48,3,1,2,1,2,258,0.023255814,0,0,3
JFreeChart,org.jfree.chart.renderer.xy,StandardXYItemRenderer,352,598,74,66,91,179,66,38,9,25,950,0.629473684,140,0.471428571,104
JFreeChart,org.jfree.chart.renderer.xy,CyclicXYItemRenderer,780,0,118,0,125,0,64,0,5,0,780,0,118,0,64
JFreeChart,org.jfree.chart.renderer.xy,CyclicXYItemRenderer.OverwriteDataSet,109,0,6,0,28,0,17,0,14,0,109,0,6,0,17
JFreeChart,org.jfree.chart.renderer.xy,DeviationRenderer.State,14,0,0,0,4,0,1,0,1,0,14,0,0,0,1
JFreeChart,org.jfree.chart.renderer.xy,XYDifferenceRenderer,1661,255,205,19,440,81,120,17,13,12,1916,0.13308977,224,0.084821429,137
JFreeChart,org.jfree.chart.renderer.xy,XYBoxAndWhiskerRenderer,738,518,62,30,157,139,47,22,5,18,1256,0.412420382,92,0.326086957,69
JFreeChart,org.jfree.chart.renderer.xy,DefaultXYItemRenderer,0,3,0,0,0,1,0,1,0,1,3,1,0,0,1
JFreeChart,org.jfree.chart.renderer.xy,XYLineAndShapeRenderer.State,7,24,0,0,3,8,2,2,2,2,31,0.774193548,0,0,4
JFreeChart,org.jfree.chart.renderer.xy,AbstractXYItemRenderer,1359,875,139,89,375,284,106,61,18,35,2234,0.391674127,228,0.390350877,167
JFreeChart,org.jfree.chart.renderer.xy,DeviationRenderer,362,51,32,6,77,16,26,5,8,4,413,0.123486683,38,0.157894737,31
JFreeChart,org.jfree.chart.renderer.xy,XYBarRenderer.XYBarRendererState,14,0,0,0,6,0,3,0,3,0,14,0,0,0,3
JFreeChart,org.jfree.chart.renderer.xy,XYAreaRenderer2,146,405,22,18,40,112,19,13,1,11,551,0.735027223,40,0.45,32
JFreeChart,org.jfree.chart.renderer.xy,XYBubbleRenderer,292,138,35,12,82,41,25,6,2,5,430,0.320930233,47,0.255319149,31
JFreeChart,org.jfree.chart.renderer.xy,XYErrorRenderer,350,141,26,14,72,48,21,16,6,11,491,0.287169043,40,0.35,37
JFreeChart,org.jfree.chart.renderer.xy,StandardXYItemRenderer.State,14,4,0,0,6,2,4,1,4,1,18,0.222222222,0,0,5
JFreeChart,org.jfree.chart.renderer.xy,GradientXYBarPainter,630,74,41,9,133,23,26,8,5,4,704,0.105113636,50,0.18,34
JFreeChart,org.jfree.chart.renderer.xy,XYItemRendererState,6,27,0,0,2,11,2,5,2,5,33,0.818181818,0,0,7
JFreeChart,org.jfree.chart.renderer.xy,XYDotRenderer,146,178,18,16,39,59,17,13,3,10,324,0.549382716,34,0.470588235,30
JFreeChart,org.jfree.chart.renderer.xy,XYSplineRenderer,757,79,60,10,132,30,39,9,7,6,836,0.094497608,70,0.142857143,48
JFreeChart,org.jfree.chart.renderer.xy,XYStepRenderer,125,264,21,29,34,68,17,17,0,9,389,0.678663239,50,0.58,34
JFreeChart,org.jfree.chart.renderer.xy,XYShapeRenderer,283,233,36,24,78,76,32,23,11,14,516,0.451550388,60,0.4,55
JFreeChart,org.jfree.chart.renderer.xy,SamplingXYLineRenderer.State,37,0,0,0,13,0,2,0,2,0,37,0,0,0,2
JFreeChart,org.jfree.chart.renderer.xy,VectorRenderer,503,37,44,4,119,11,27,3,3,3,540,0.068518519,48,0.083333333,30
JFreeChart,org.jfree.chart.renderer.xy,XYAreaRenderer,314,570,45,51,70,169,35,35,2,20,884,0.64479638,96,0.53125,70
JFreeChart,org.jfree.chart.renderer.xy,ClusteredXYBarRenderer,333,121,53,13,84,33,30,11,2,6,454,0.266519824,66,0.196969697,41
JFreeChart,org.jfree.chart.renderer.xy,XYBlockRenderer,360,199,32,24,88,59,27,16,5,10,559,0.355992844,56,0.428571429,43
JFreeChart,org.jfree.chart.renderer.xy,YIntervalRenderer,250,41,18,4,65,15,13,6,3,5,291,0.140893471,22,0.181818182,19
JFreeChart,org.jfree.chart.renderer.xy,CandlestickRenderer,618,284,64,28,164,97,43,34,6,24,902,0.314855876,92,0.304347826,77
JFreeChart,org.jfree.chart.renderer.xy,XYStepAreaRenderer,161,484,48,50,43,141,39,30,1,19,645,0.750387597,98,0.510204082,69
JFreeChart,org.jfree.chart.renderer.xy,HighLowRenderer,371,128,53,15,96,47,34,17,6,11,499,0.256513026,68,0.220588235,51
JFreeChart,org.jfree.chart.renderer.xy,XYSplineRenderer.XYSplineState,14,0,0,0,4,0,1,0,1,0,14,0,0,0,1
JFreeChart,org.jfree.chart.renderer.xy,SamplingXYLineRenderer,316,0,28,0,84,0,22,0,8,0,316,0,28,0,22
JFreeChart,org.jfree.chart.renderer.xy,StackedXYAreaRenderer2,788,130,54,14,193,38,33,13,4,8,918,0.1416122,68,0.205882353,46
JFreeChart,org.jfree.chart.renderer.xy,StackedXYAreaRenderer,219,416,49,39,66,123,35,25,2,14,635,0.65511811,88,0.443181818,60
JFreeChart,org.jfree.chart.renderer.xy,StackedXYBarRenderer,425,80,78,8,116,27,45,8,4,6,505,0.158415842,86,0.093023256,53
JFreeChart,org.jfree.chart.renderer.xy,XYSplineRenderer.FillType,0,44,0,0,0,5,0,1,0,1,44,1,0,0,1
JFreeChart,org.jfree.chart.renderer.xy,StackedXYAreaRenderer.StackedXYAreaRendererState,0,46,0,0,0,16,0,8,0,8,46,1,0,0,8
JFreeChart,org.jfree.chart.renderer.xy,XYBarRenderer,982,400,173,37,276,135,110,40,18,27,1382,0.289435601,210,0.176190476,150
JFreeChart,org.jfree.chart.renderer.xy,XYAreaRenderer.XYAreaRendererState,0,14,0,0,0,4,0,1,0,1,14,1,0,0,1
JFreeChart,org.jfree.chart.renderer.xy,XYLineAndShapeRenderer,234,806,59,77,64,235,58,54,7,37,1040,0.775,136,0.566176471,112
JFreeChart,org.jfree.chart.renderer.xy,StandardXYBarPainter,197,17,31,3,57,8,19,4,3,3,214,0.079439252,34,0.088235294,23
JFreeChart,org.jfree.data,KeyedObject,4,64,2,8,2,21,2,9,0,6,68,0.941176471,10,0.8,11
JFreeChart,org.jfree.data,DefaultKeyedValues2D,50,530,12,56,17,135,14,43,2,21,580,0.913793103,68,0.823529412,57
JFreeChart,org.jfree.data,DefaultKeyedValues,45,457,10,34,12,111,11,33,2,20,502,0.910358566,44,0.772727273,44
JFreeChart,org.jfree.data,KeyedValuesItemKey,73,0,6,0,21,0,8,0,5,0,73,0,6,0,8
JFreeChart,org.jfree.data,DataUtils,69,260,12,36,16,64,10,24,2,8,329,0.790273556,48,0.75,34
JFreeChart,org.jfree.data,Range,45,420,8,64,7,96,9,50,2,21,465,0.903225806,72,0.888888889,59
JFreeChart,org.jfree.data,RangeType,14,58,5,7,5,20,3,9,0,6,72,0.805555556,12,0.583333333,12
JFreeChart,org.jfree.data,DomainOrder,14,58,5,7,5,20,3,9,0,6,72,0.805555556,12,0.583333333,12
JFreeChart,org.jfree.data,KeyedValueComparator,31,117,7,21,11,41,9,9,2,2,148,0.790540541,28,0.75,18
JFreeChart,org.jfree.data,UnknownKeyException,0,4,0,0,0,2,0,1,0,1,4,1,0,0,1
JFreeChart,org.jfree.data,KeyedObjects2D,61,549,12,58,18,139,14,43,2,20,610,0.9,70,0.828571429,57
JFreeChart,org.jfree.data,DefaultKeyedValue,49,57,9,7,6,19,8,8,2,6,106,0.537735849,16,0.4375,16
JFreeChart,org.jfree.data,KeyedObjects,97,237,20,24,27,68,18,20,4,12,334,0.709580838,44,0.545454545,38
JFreeChart,org.jfree.data,KeyedValues2DItemKey,148,0,10,0,38,0,13,0,8,0,148,0,10,0,13
JFreeChart,org.jfree.data,ComparableObjectSeries,68,359,11,49,20,97,12,38,3,17,427,0.840749415,60,0.816666667,50
JFreeChart,org.jfree.data,ComparableObjectItem,12,79,3,9,6,22,4,10,1,7,91,0.868131868,12,0.75,14
JFreeChart,org.jfree.data,KeyToGroupMap,45,255,9,33,15,79,8,25,1,11,300,0.85,42,0.785714286,33
JFreeChart,org.jfree.data,KeyedValueComparatorType,30,17,6,0,10,7,6,2,3,2,47,0.361702128,6,0,8
JFreeChart,org.jfree.chart.ui,Layer,3,34,0,0,1,8,1,2,1,2,37,0.918918919,0,0,3
JFreeChart,org.jfree.chart.ui,LCBLayout,524,0,40,0,92,0,28,0,8,0,524,0,40,0,28
JFreeChart,org.jfree.chart.ui,StrokeChooserPanel,64,0,2,0,13,0,4,0,3,0,64,0,2,0,4
JFreeChart,org.jfree.chart.ui,TextAnchor,58,284,38,58,27,78,35,27,1,13,342,0.830409357,96,0.604166667,62
JFreeChart,org.jfree.chart.ui,UIUtils,203,0,6,0,47,0,12,0,9,0,203,0,6,0,12
JFreeChart,org.jfree.chart.ui,Size2D,58,20,8,0,16,8,9,4,5,4,78,0.256410256,8,0,13
JFreeChart,org.jfree.chart.ui,FontDisplayField,46,0,2,0,13,0,6,0,5,0,46,0,2,0,6
JFreeChart,org.jfree.chart.ui,StrokeSample,168,0,4,0,39,0,8,0,6,0,168,0,4,0,8
JFreeChart,org.jfree.chart.ui,Align,81,0,12,0,18,0,7,0,1,0,81,0,12,0,7
JFreeChart,org.jfree.chart.ui,StandardGradientPaintTransformer,121,45,10,8,29,17,8,8,2,5,166,0.271084337,18,0.444444444,16
JFreeChart,org.jfree.chart.ui,RectangleAnchor,156,209,23,13,22,47,16,7,1,4,365,0.57260274,36,0.361111111,23
JFreeChart,org.jfree.chart.ui,VerticalAlignment,11,61,4,8,5,21,5,7,1,5,72,0.847222222,12,0.666666667,12
JFreeChart,org.jfree.chart.ui,NumberCellRenderer,34,0,4,0,14,0,4,0,2,0,34,0,4,0,4
JFreeChart,org.jfree.chart.ui,PaintSample,90,0,0,0,22,0,5,0,5,0,90,0,0,0,5
JFreeChart,org.jfree.chart.ui,RectangleEdge,50,116,17,21,21,41,13,16,2,8,166,0.698795181,38,0.552631579,29
JFreeChart,org.jfree.chart.ui,GradientPaintTransformType,13,75,5,9,7,30,6,7,1,5,88,0.852272727,14,0.642857143,13
JFreeChart,org.jfree.chart.ui,StrokeChooserPanel.new ActionListener() {...},11,0,0,0,3,0,2,0,2,0,11,0,0,0,2
JFreeChart,org.jfree.chart.ui,HorizontalAlignment,7,69,3,9,3,26,4,8,1,5,76,0.907894737,12,0.75,12
JFreeChart,org.jfree.chart.ui,ApplicationFrame,22,0,2,0,13,0,9,0,8,0,22,0,2,0,9
JFreeChart,org.jfree.chart.ui,LengthAdjustmentType,13,59,3,9,5,21,5,7,2,4,72,0.819444444,12,0.75,12
JFreeChart,org.jfree.chart.ui,RectangleInsets,399,315,42,22,71,82,36,26,7,23,714,0.441176471,64,0.34375,62
JFreeChart,org.jfree.chart.ui,FontChooserPanel,337,0,20,0,73,0,17,0,7,0,337,0,20,0,17
JFreeChart,org.jfree.chart.text,TextBox,178,309,30,16,43,82,35,13,13,12,487,0.63449692,46,0.347826087,48
JFreeChart,org.jfree.chart.text,AttributedStringUtils,8,72,4,14,2,23,4,6,0,1,80,0.9,18,0.777777778,10
JFreeChart,org.jfree.chart.text,TextUtils,293,810,55,69,84,212,53,32,8,15,1103,0.734360834,124,0.556451613,85
JFreeChart,org.jfree.chart.text,TextFragment,68,200,17,15,18,54,16,16,2,14,268,0.746268657,32,0.46875,32
JFreeChart,org.jfree.chart.text,TextBlock,41,307,20,28,11,82,18,20,2,12,348,0.882183908,48,0.583333333,38
JFreeChart,org.jfree.chart.text,TextLine,57,219,12,16,16,60,13,14,2,11,276,0.793478261,28,0.571428571,27
JFreeChart,org.jfree.chart.text,TextBlockAnchor,23,115,8,16,9,41,7,11,1,5,138,0.833333333,24,0.666666667,18
JFreeChart,org.jfree.chart.text,G2TextMeasurer,0,25,0,0,0,8,0,2,0,2,25,1,0,0,2
JFreeChart,org.jfree.data.function,LineFunction2D,4,59,2,4,2,17,2,7,0,6,63,0.936507937,6,0.666666667,9
JFreeChart,org.jfree.data.function,NormalDistributionFunction2D,26,70,3,5,5,19,4,6,1,5,96,0.729166667,8,0.625,10
JFreeChart,org.jfree.data.function,PowerFunction2D,12,51,2,4,3,16,3,6,1,5,63,0.80952381,6,0.666666667,9
JFreeChart,org.jfree.data.function,PolynomialFunction2D,27,38,3,1,5,10,3,5,1,5,65,0.584615385,4,0.25,8
JFreeChart,org.jfree.data.json.impl,JSONArray,107,0,16,0,41,0,14,0,6,0,107,0,16,0,14
JFreeChart,org.jfree.data.json.impl,JSONValue,322,0,81,0,99,0,49,0,5,0,322,0,81,0,49
JFreeChart,org.jfree.data.json.impl,JSONObject,157,0,14,0,50,0,15,0,8,0,157,0,14,0,15
JFreeChart,org.jfree.data.xy,DefaultTableXYDataset,120,542,21,53,31,140,25,48,9,27,662,0.818731118,74,0.716216216,73
JFreeChart,org.jfree.data.xy,VectorSeries,16,58,0,0,4,16,2,8,2,8,74,0.783783784,0,0,10
JFreeChart,org.jfree.data.xy,XYBarDataset,100,110,8,6,23,27,16,13,10,12,210,0.523809524,14,0.428571429,29
JFreeChart,org.jfree.data.xy,XYDatasetTableModel,99,0,12,0,32,0,16,0,10,0,99,0,12,0,16
JFreeChart,org.jfree.data.xy,XYInterval,4,84,2,12,2,26,2,12,0,7,88,0.954545455,14,0.857142857,14
JFreeChart,org.jfree.data.xy,DefaultHighLowDataset,127,125,12,18,38,33,23,11,16,3,252,0.496031746,30,0.6,34
JFreeChart,org.jfree.data.xy,WindDataItem,26,65,7,9,10,18,10,4,3,3,91,0.714285714,16,0.5625,14
JFreeChart,org.jfree.data.xy,XYIntervalDataItem,10,64,5,5,5,18,5,7,0,7,74,0.864864865,10,0.5,12
JFreeChart,org.jfree.data.xy,DefaultWindDataset,108,197,12,18,26,45,15,13,6,7,305,0.645901639,30,0.6,28
JFreeChart,org.jfree.data.xy,CategoryTableXYDataset,70,163,6,6,19,44,14,19,10,17,233,0.699570815,12,0.5,33
JFreeChart,org.jfree.data.xy,Vector,26,73,2,6,5,19,5,6,3,4,99,0.737373737,8,0.75,11
JFreeChart,org.jfree.data.xy,DefaultOHLCDataset,75,121,10,8,22,34,15,14,8,12,196,0.617346939,18,0.444444444,29
JFreeChart,org.jfree.data.xy,YIntervalSeries,0,64,0,0,0,17,0,9,0,9,64,1,0,0,9
JFreeChart,org.jfree.data.xy,MatrixSeriesCollection,169,57,18,4,41,19,22,5,11,5,226,0.252212389,22,0.181818182,27
JFreeChart,org.jfree.data.xy,XYDataItem,34,133,5,13,9,43,7,15,2,11,167,0.796407186,18,0.722222222,22
JFreeChart,org.jfree.data.xy,XYIntervalSeries,0,82,0,0,0,21,0,11,0,11,82,1,0,0,11
JFreeChart,org.jfree.data.xy,DefaultXYDataset,80,286,10,24,20,61,13,19,4,11,366,0.781420765,34,0.705882353,32
JFreeChart,org.jfree.data.xy,AbstractXYDataset,0,33,1,3,0,12,1,5,0,4,33,1,4,0.75,6
JFreeChart,org.jfree.data.xy,AbstractXYZDataset,14,3,2,0,5,1,2,1,1,1,17,0.176470588,2,0,3
JFreeChart,org.jfree.data.xy,DefaultXYZDataset,68,360,11,27,16,75,16,20,5,12,428,0.841121495,38,0.710526316,36
JFreeChart,org.jfree.data.xy,VectorSeriesCollection,130,89,5,7,28,27,14,10,10,8,219,0.406392694,12,0.583333333,24
JFreeChart,org.jfree.data.xy,DefaultIntervalXYDataset,91,482,15,33,21,97,22,22,7,13,573,0.841186736,48,0.6875,44
JFreeChart,org.jfree.data.xy,XYItemKey,139,0,10,0,36,0,13,0,8,0,139,0,10,0,13
JFreeChart,org.jfree.data.xy,XYCoordinate,71,75,11,7,17,20,10,7,4,4,146,0.51369863,18,0.388888889,17
JFreeChart,org.jfree.data.xy,XIntervalDataItem,6,44,3,3,3,12,3,5,0,5,50,0.88,6,0.5,8
JFreeChart,org.jfree.data.xy,XIntervalSeries,0,64,0,0,0,17,0,9,0,9,64,1,0,0,9
JFreeChart,org.jfree.data.xy,MatrixSeries,10,151,2,16,3,35,3,17,1,10,161,0.937888199,18,0.888888889,20
JFreeChart,org.jfree.data.xy,IntervalXYDelegate,62,293,11,31,15,83,15,28,4,18,355,0.825352113,42,0.738095238,43
JFreeChart,org.jfree.data.xy,XIntervalSeriesCollection,166,94,7,9,36,27,18,10,13,7,260,0.361538462,16,0.5625,28
JFreeChart,org.jfree.data.xy,VectorDataItem,24,29,3,1,8,7,5,3,3,3,53,0.547169811,4,0.25,8
JFreeChart,org.jfree.data.xy,YWithXInterval,4,56,2,8,2,18,2,8,0,5,60,0.933333333,10,0.8,10
JFreeChart,org.jfree.data.xy,YInterval,4,56,2,8,2,18,2,8,0,5,60,0.933333333,10,0.8,10
JFreeChart,org.jfree.data.xy,XYIntervalSeriesCollection,95,181,7,11,19,44,12,19,7,15,276,0.655797101,18,0.611111111,31
JFreeChart,org.jfree.data.xy,YIntervalSeriesCollection,94,150,6,10,21,38,11,17,7,13,244,0.614754098,16,0.625,28
JFreeChart,org.jfree.data.xy,OHLCDataItem,26,103,7,9,10,25,10,7,3,6,129,0.798449612,16,0.5625,17
JFreeChart,org.jfree.data.xy,NormalizedMatrixSeries,72,0,0,0,19,0,6,0,6,0,72,0,0,0,6
JFreeChart,org.jfree.data.xy,YIntervalDataItem,6,44,3,3,3,12,3,5,0,5,50,0.88,6,0.5,8
JFreeChart,org.jfree.data.xy,XYSeriesCollection,103,600,20,70,32,164,17,65,3,34,703,0.853485064,90,0.777777778,82
JFreeChart,org.jfree.data.xy,AbstractIntervalXYDataset,0,59,2,6,0,21,2,7,0,5,59,1,8,0.75,9
JFreeChart,org.jfree.data.xy,XYSeries,114,887,23,101,29,234,26,81,5,40,1001,0.886113886,124,0.814516129,107
JFreeChart,org.jfree.data.statistics,HistogramType,29,47,9,5,11,17,9,4,2,4,76,0.618421053,14,0.357142857,13
JFreeChart,org.jfree.data.statistics,DefaultMultiValueCategoryDataset,100,275,22,26,29,73,23,20,8,11,375,0.733333333,48,0.541666667,43
JFreeChart,org.jfree.data.statistics,BoxAndWhiskerCalculator,35,261,12,22,10,68,9,13,1,4,296,0.881756757,34,0.647058824,22
JFreeChart,org.jfree.data.statistics,DefaultBoxAndWhiskerXYDataset,66,318,18,24,19,98,23,25,6,21,384,0.828125,42,0.571428571,48
JFreeChart,org.jfree.data.statistics,MeanAndStandardDeviation,18,77,3,9,2,26,4,10,1,7,95,0.810526316,12,0.75,14
JFreeChart,org.jfree.data.statistics,Statistics,276,393,25,43,53,100,19,29,4,10,669,0.587443946,68,0.632352941,48
JFreeChart,org.jfree.data.statistics,SimpleHistogramBin,29,197,11,39,9,54,9,27,0,11,226,0.871681416,50,0.78,36
JFreeChart,org.jfree.data.statistics,DefaultStatisticalCategoryDataset,65,652,21,91,27,190,26,59,7,22,717,0.909344491,112,0.8125,85
JFreeChart,org.jfree.data.statistics,DefaultBoxAndWhiskerCategoryDataset,117,598,36,54,45,195,42,47,10,34,715,0.836363636,90,0.6,89
JFreeChart,org.jfree.data.statistics,HistogramBin,22,80,10,10,6,20,11,7,1,7,102,0.784313725,20,0.5,18
JFreeChart,org.jfree.data.statistics,SimpleHistogramDataset,156,181,13,17,34,50,29,13,17,10,337,0.537091988,30,0.566666667,42
JFreeChart,org.jfree.data.statistics,HistogramDataset,102,407,13,33,26,87,17,27,6,15,509,0.799607073,46,0.717391304,44
JFreeChart,org.jfree.data.statistics,BoxAndWhiskerItem,50,166,10,14,12,43,11,14,1,12,216,0.768518519,24,0.583333333,25
JFreeChart,org.jfree.data.statistics,Regression,526,432,50,12,84,92,30,8,3,4,958,0.450939457,62,0.193548387,38
JFreeChart,org.jfree.chart.block,RectangleConstraint,26,313,6,22,5,87,7,27,1,19,339,0.923303835,28,0.785714286,34
JFreeChart,org.jfree.chart.block,ColorBlock,47,52,1,5,13,19,5,6,4,4,99,0.525252525,6,0.833333333,11
JFreeChart,org.jfree.chart.block,BorderArrangement,157,1258,30,96,32,245,27,47,1,10,1415,0.889045936,126,0.761904762,74
JFreeChart,org.jfree.chart.block,EmptyBlock,17,28,0,0,5,8,2,3,2,3,45,0.622222222,0,0,5
JFreeChart,org.jfree.chart.block,LengthConstraintType,50,22,12,0,17,9,10,2,4,2,72,0.305555556,12,0,12
JFreeChart,org.jfree.chart.block,GridArrangement,63,587,15,59,20,126,15,36,1,13,650,0.903076923,74,0.797297297,51
JFreeChart,org.jfree.chart.block,LabelBlock,116,213,11,17,32,64,18,19,11,12,329,0.647416413,28,0.607142857,37
JFreeChart,org.jfree.chart.block,BlockBorder,73,142,6,10,15,42,9,11,3,9,215,0.660465116,16,0.625,20
JFreeChart,org.jfree.chart.block,ColumnArrangement,419,64,48,12,97,23,31,10,7,4,483,0.132505176,60,0.2,41
JFreeChart,org.jfree.chart.block,BlockParams,14,19,0,0,6,8,4,3,4,3,33,0.575757576,0,0,7
JFreeChart,org.jfree.chart.block,FlowArrangement,177,367,28,34,40,90,24,21,4,10,544,0.674632353,62,0.548387097,45
JFreeChart,org.jfree.chart.block,LineBorder,157,95,13,9,38,30,11,9,4,5,252,0.376984127,22,0.409090909,20
JFreeChart,org.jfree.chart.block,BlockContainer,14,205,3,19,5,61,5,20,2,12,219,0.936073059,22,0.863636364,25
JFreeChart,org.jfree.chart.block,AbstractBlock,81,412,4,30,16,120,12,42,8,29,493,0.835699797,34,0.882352941,54
JFreeChart,org.jfree.chart.block,CenterArrangement,255,53,34,2,59,13,27,4,9,4,308,0.172077922,36,0.055555556,31
JFreeChart,org.jfree.chart.block,BlockResult,0,13,0,0,0,6,0,3,0,3,13,1,0,0,3
JFreeChart,org.jfree.chart.plot.dial,StandardDialRange,172,216,11,13,51,54,21,13,12,10,388,0.556701031,24,0.541666667,34
JFreeChart,org.jfree.chart.plot.dial,StandardDialScale,422,559,29,41,113,142,46,38,27,22,981,0.569826707,70,0.585714286,84
JFreeChart,org.jfree.chart.plot.dial,DialPointer.Pin,66,111,2,6,17,35,5,10,3,8,177,0.627118644,8,0.75,15
JFreeChart,org.jfree.chart.plot.dial,StandardDialFrame,102,194,2,12,27,55,9,15,7,10,296,0.655405405,14,0.857142857,24
JFreeChart,org.jfree.chart.plot.dial,DialPointer.Pointer,222,100,3,7,55,32,9,9,6,7,322,0.310559006,10,0.7,18
JFreeChart,org.jfree.chart.plot.dial,DialValueIndicator,272,427,11,29,73,119,28,32,21,19,699,0.610872675,40,0.725,60
JFreeChart,org.jfree.chart.plot.dial,DialPointer,38,47,3,5,14,15,9,5,6,4,85,0.552941176,8,0.625,14
JFreeChart,org.jfree.chart.plot.dial,DialBackground,28,114,2,8,10,37,5,13,4,9,142,0.802816901,10,0.8,18
JFreeChart,org.jfree.chart.plot.dial,DialPlot,487,377,53,29,128,105,55,27,25,16,864,0.436342593,82,0.353658537,82
JFreeChart,org.jfree.chart.plot.dial,DialLayerChangeEvent,3,7,0,0,1,3,1,1,1,1,10,0.7,0,0,2
JFreeChart,org.jfree.chart.plot.dial,ArcDialFrame,231,316,3,19,58,82,14,22,11,14,547,0.577696527,22,0.863636364,36
JFreeChart,org.jfree.chart.plot.dial,DialTextAnnotation,85,234,4,14,25,60,13,16,9,11,319,0.73354232,18,0.777777778,29
JFreeChart,org.jfree.chart.plot.dial,DialCap,59,179,2,12,17,52,8,15,6,10,238,0.75210084,14,0.857142857,23
JFreeChart,org.jfree.chart.plot.dial,AbstractDialLayer,24,98,3,7,9,26,6,10,3,8,122,0.803278689,10,0.7,16
JFreeChart,org.jfree.chart.servlet,ServletUtilities,341,0,34,0,105,0,33,0,16,0,341,0,34,0,33
JFreeChart,org.jfree.chart.servlet,ChartDeleter,46,0,4,0,15,0,7,0,5,0,46,0,4,0,7
JFreeChart,org.jfree.chart.servlet,DisplayChart,103,0,20,0,32,0,13,0,3,0,103,0,20,0,13
JFreeChart,org.jfree.data.resources,DataPackageResources_fr,35,0,0,0,6,0,3,0,3,0,35,0,0,0,3
JFreeChart,org.jfree.data.resources,DataPackageResources_es,35,0,0,0,6,0,3,0,3,0,35,0,0,0,3
JFreeChart,org.jfree.data.resources,DataPackageResources_de,35,0,0,0,6,0,3,0,3,0,35,0,0,0,3
JFreeChart,org.jfree.data.resources,DataPackageResources,0,35,0,0,0,6,0,3,0,3,35,1,0,0,3
JFreeChart,org.jfree.data.resources,DataPackageResources_ru,35,0,0,0,6,0,3,0,3,0,35,0,0,0,3
JFreeChart,org.jfree.data.resources,DataPackageResources_pl,35,0,0,0,6,0,3,0,3,0,35,0,0,0,3
JFreeChart,org.jfree.chart.annotations,XYDataImageAnnotation,289,0,26,0,81,0,29,0,16,0,289,0,26,0,29
JFreeChart,org.jfree.chart.annotations,XYTitleAnnotation,126,310,23,21,40,80,28,9,9,6,436,0.711009174,44,0.477272727,37
JFreeChart,org.jfree.chart.annotations,CategoryLineAnnotation,133,252,6,14,40,75,7,22,3,16,385,0.654545455,20,0.7,29
JFreeChart,org.jfree.chart.annotations,XYDrawableAnnotation,136,155,8,14,31,37,7,10,1,5,291,0.532646048,22,0.636363636,17
JFreeChart,org.jfree.chart.annotations,XYBoxAnnotation,49,276,12,18,14,69,14,10,2,7,325,0.849230769,30,0.6,24
JFreeChart,org.jfree.chart.annotations,CategoryPointerAnnotation,263,303,4,20,58,83,12,23,9,14,566,0.535335689,24,0.833333333,35
JFreeChart,org.jfree.chart.annotations,XYTextAnnotation,57,486,6,32,19,145,12,39,6,26,543,0.895027624,38,0.842105263,51
JFreeChart,org.jfree.chart.annotations,CategoryTextAnnotation,96,129,6,10,30,39,5,14,1,10,225,0.573333333,16,0.625,19
JFreeChart,org.jfree.chart.annotations,XYPointerAnnotation,311,300,12,18,69,81,16,22,9,14,611,0.490998363,30,0.6,38
JFreeChart,org.jfree.chart.annotations,XYPolygonAnnotation,212,144,21,13,52,41,20,10,7,6,356,0.404494382,34,0.382352941,30
JFreeChart,org.jfree.chart.annotations,XYImageAnnotation,231,0,22,0,69,0,23,0,12,0,231,0,22,0,23
JFreeChart,org.jfree.chart.annotations,XYLineAnnotation,157,171,14,14,46,44,11,11,2,6,328,0.521341463,28,0.5,22
JFreeChart,org.jfree.chart.annotations,TextAnnotation,4,239,2,14,2,76,2,24,0,18,243,0.983539095,16,0.875,26
JFreeChart,org.jfree.chart.annotations,XYShapeAnnotation,193,145,14,12,46,41,12,10,3,6,338,0.428994083,26,0.461538462,22
JFreeChart,org.jfree.chart.annotations,AbstractXYAnnotation,61,41,11,5,21,14,11,5,3,5,102,0.401960784,16,0.3125,16
JFreeChart,org.jfree.chart.annotations,AbstractAnnotation,21,83,4,4,7,25,6,9,3,8,104,0.798076923,8,0.5,15
JFreeChart,org.jfree.chart.event,OverlayChangeEvent,0,4,0,0,0,2,0,1,0,1,4,1,0,0,1
JFreeChart,org.jfree.chart.event,ChartChangeEventType,50,22,12,0,17,9,10,2,4,2,72,0.305555556,12,0,12
JFreeChart,org.jfree.chart.event,PlotChangeEvent,3,7,0,0,1,3,1,1,1,1,10,0.7,0,0,2
JFreeChart,org.jfree.chart.event,MarkerChangeEvent,0,10,0,0,0,4,0,2,0,2,10,1,0,0,2
JFreeChart,org.jfree.chart.event,TitleChangeEvent,3,7,0,0,1,3,1,1,1,1,10,0.7,0,0,2
JFreeChart,org.jfree.chart.event,AnnotationChangeEvent,3,10,0,0,1,4,1,1,1,1,13,0.769230769,0,0,2
JFreeChart,org.jfree.chart.event,AxisChangeEvent,0,10,0,0,0,4,0,2,0,2,10,1,0,0,2
JFreeChart,org.jfree.chart.event,ChartChangeEvent,12,24,0,0,4,10,3,4,3,4,36,0.666666667,0,0,7
JFreeChart,org.jfree.chart.event,RendererChangeEvent,0,21,0,0,0,8,0,4,0,4,21,1,0,0,4
JFreeChart,org.jfree.chart.event,ChartProgressEvent,21,13,0,0,9,5,6,1,6,1,34,0.382352941,0,0,7
